//#######//
/##     ##/
## $   # ##
#     #   #
#   ##   .#
###  @  ###
#.   ##   #
#   #     #
## #   $ ##
/##     ##/
//#######//
