//####///
###  ####
#       #
#@$***. #
#       #
#########
