#######//
#     ###
#  @$$..#
#### ## #
//#     #
//#  ####
//#  #///
//####///
