######/#####
#    ###   #
# $$     #@#
# $ #...   #
#   ########
#####///////
