############//////
#       # @#//////
#  #### #  #//////
#  #  # #  #//////
#  #  # #  #//////
#  ####    #######
#     ..####     #
#  ###..     $ $ #
###### ######    #
#    # #    ######
#    # #    #/////
#  ### ###  #/////
#           #/////
#  # $ $ #  #/////
#  #     #  #/////
#############/////
