/#########/
##   .   ##
#  $ . $  #
# $#$.$#$ #
#  $ . $  #
#....@....#
#  $ . $  #
# $#$.$#$ #
#  $ . $  #
##   .   ##
/#########/
