##########
#   #   .#
#   #$   #
#@       #
#   #$   #
#   #   .#
##########
