//////#####
//////#.  #
//////#.# #
#######.# #
# @ $ $ $ #
# # # # ###
#       #//
#########//
