///////####/
////####  #/
////#     #/
////#  #  #/
###### # ##/
#      # #//
#   #  # #//
#####$## ###
#@     #   #
###### # # #
/////#    .#
/////#######
