#####////
#   ##///
# $  #///
## $ ####
/###@.  #
//#  .# #
//#     #
//#######
