////####/
////#  #/
////#  #/
////#  #/
###### #/
#      #/
#   # .#/
##### ###
////# #@#
////# # #
////#$# #
////#   #
////#####
