################
#@ #   ..#     #
#  #  $..#  $  #
#  #  #..#  #  #
# $#$$#$$#$$#$ #
#  #  #..#  #  #
#  $  #..$  #  #
#     #..   #  #
################
