//######
//# ..@#
//# $$ #
//## ###
///# #//
///# #//
#### #//
#    ##/
# #   #/
#   # #/
###   #/
//#####/
