####///////////
#  ############
# $ $ $ $ $ @ #
# .....       #
###############
