//#######//
###     #//
# $ $   #//
# ### #####
# @ . .   #
#   ###   #
#####/#####
