######
#.  .#
# #  #
#.$$$#
#  @ #
######
