############/
#          #/
# ####### @##
# #         #
# #  $   #  #
# $$ #####  #
###  #/# ...#
//####/#    #
///////######
