#########
#.  @  .#
#.$$$$$.#
#.     .#
#.$$*$$.#
#.     .#
#.$$$$$.#
#.     .#
#########