/////#####
/////#   ##
/////#    #
/######   #
##     #. #
# $ $ @  ##
# ######.#/
#        #/
##########/
