########
#@  .. #
#  $#  #
##   # #
#   $  #
##     #
########
