/#########/
##   #   ##
#    #    #
#  $ # $  #
#   *.*   #
####.@.####
#   *.*   #
#  $ # $  #
#    #    #
##   #   ##
/#########/
